SUBMODULE	CHANNEL NAME	TAGS
alltwitter 	@AllTwitter	#twitter
android 	@reddit_android	#android
arma 	@r_arma	#gaming
asiangirlsbeingcute 	@asiangirlsbeingcute	#fun #gif
awwnime 	@awwnime	#anime
amd	@RAyyMD	#AMD #pc
bestoftweets 	@bestoftweets	#twitter
blackpeopletweets 	@blackpeopletweets	#twitter
cats 	@RedditCats	#cats #pic #gif
celebrityarmpits 	@CelebrityArmpits	#celebrity #armpits
comics 	@r_comics	#comics
completeanarchy_tg	@completeanarchy_tg	
dailyfoodporn 	@dailyfoodporn	#sfw #porn
dash_cams 	@dash_cams	#dashcam
datascientology 	@datascientology	#datascience #maps #data #infographics
deepfriedmemes 	@deepfriedmemeschannel	#memes
denpasong 	@denpasong	
facepalmers 	@facepalmers	
fakealbumcovers 	@fakealbumcovers	#music #albums #fake
food 	@reddit_food	#sfw #porn
freefolk 	@r_freefolk	
gifffs 	@GIFFFs	#gif
greentext 	@r_greentext	#text
happiness 	@get_happiness	#eyebleach
history 	@RedditHistory	#history #photos
ichimechtenleben 	@ichimechtenleben	
im14andthisisdeep 	@wokesouls	
indepthstories 	@indepthstories	
indiancelebs 	@Indiancelebs	#india
ingress 	@IngressReddit	#gaming
ingressprimefeedback 	@IngressPrimeFeedback	#gaming
instant_regret 	@instant_regret	
jenkins 	@r_jenkins	#programming
jenkinsci 	@jenkinsci	#programming
just_hmmm 	@just_hmmm	#hmmm
livestreamfail 	@LivestreamFail	
loliconsunite 	@loliconsunite	
maybemaybemaybe 	@MaybeMaybeMaybe	#gif
news 	@news756	#news
nfl_reddit 	@NFL_reddit	#sport
oldschoolcool 	@OldSchoolCool	#oldschool #pic
politicalhumor 	@PoliticalHumor	#fun
proceduralgeneration 	@proceduralgeneration	#art
programmer_humor 	@programmer_humor	#programming
pythondaily 	@pythondaily	#python #programming
r_2meirl4meirl 	@r_2meirl4meirl	#memes
r_anime_irl 	@r_animeirl	#anime #memes
r_animemes 	@r_Animemes	#anime #memes
r_arthelpreddit 	@arthelpreddit	#art
r_askreddit 	@r_AskReddit	#reddit
r_behindthegifs 	@r_behindthegifs	#gif #comics
r_bettereveryloop 	@BetterEveryLoop	#gif
r_biganimetiddies 	@r_BigAnimeTiddies	#porn #anime
r_bitcoin 	@r_bitcoin	#crypto #bitcoin
r_books 	@r_books	#book
r_changemyview 	@r_changemyview	
r_chapotraphouse 	@r_ChapoTrapHouse	
r_chemicalreactionsgifs 	@r_chemicalreactiongifs	#gifs #science
r_chemistry 	@r_chemistry	#science
r_comedycemetery 	@r_ComedyCemetery	
r_contrapoints 	@r_ContraPoints	
r_cpp 	@r_cpp	#programming
r_crappydesign 	@r_crappydesign	#crappy #baddesign
r_crappyoffbrands 	@r_crappyoffbrands	#crappy
r_creepy 	@r_creepy	#creepy
r_creepyasterisks 	@r_creepyasterisks	#creepy
r_cryptocurrency 	@r_cryptocurrency	#crypto
r_damnthatsinteresting 	@r_Damnthatsinteresting	
r_dankchristianmemes 	@r_dankchristianmemes	#memes
r_dankmemes 	@r_dankmemes	#memes
r_desktops 	@r_desktops	#pc
r_digimon 	@r_digimon	#anime
r_disneyvacation 	@r_disneyvacation	#outofcontext
r_djs 	@r_djs	#music
r_dndgreentext 	@r_dndgreentext	#rpg #memes #reading #dnd #fun #pic #photos
r_dndmemes 	@r_dndmemes	#rpg #memes #pic #dnd #fun
r_dontdeadopeninside 	@r_dontdeadopeninside	#baddesign
r_explainmelikeimfive 	@r_explainmelikeimfive	#learning
r_f1 	@r_formula1	#sport
r_fantheories 	@r_fantheories	#text
r_fashion 	@reddit_fashion	#fashion
r_foxes 	@r_foxes	#animal #fox
r_freegamesonsteam 	@r_FreeGamesOnSteam	#gaming
r_funny 	@r_funny	#fun
r_furry 	@r_furry	#pic #furry
r_gaming 	@r_gaming	#gaming
r_gentlemanboners 	@r_gentlemanboners	#girls
r_getmotivated 	@r_getmotivated	#motivation #text
r_gifs 	@r_gifs	#gif #fun
r_googleplaydeals 	@r_googleplaydeals	#android
r_grandorder 	@r_grandorder	
r_gtaonline 	@r_gtaonline	#gaming
r_hentaimemes 	@r_HentaiMemes	#memes
r_highqualitygifs 	@r_HighQualityGifs	#gif
r_igthft 	@r_ImToGoingHellForThis	
r_ik_ihe 	@r_ik_ihe	#dutch #memes
r_imaginary_network 	@r_imaginary_network	
r_indiaa 	@r_indiaa	#india
r_interestingasfuck 	@r_interestingasfuck	#interesting
r_internetisbeautiful 	@r_InternetIsBeautiful	#interesting
r_jailbreak 	@r_jailbreak	#ios #apple
r_jokes 	@r_jokes	#fun #text
r_latestagecapitalism 	@r_latestagecapitalism	
r_linux 	@r_linux	#pc
r_listentothis 	@r_listentothis	#music
r_longtext 	@r_longtext	#text #longtext
r_mapporn 	@r_mapporn	#sfw #porn
r_marvelstudios 	@r_marvelstudios	#comics
r_maxestla 	@r_MaxEstLa	#french
r_me_ira 	@r_me_ira	#mems
r_me_irl 	@r_me_irl	#memes
r_mild 	@r_mild	#interesting
r_mildlyinfuriating 	@r_mildlyinfuriating	#furiating
r_minecraft 	@r_minecraft	#gaming
r_mlp 	@r_mlp	#anime
r_movies 	@r_movies	#movies
r_nocontextpics 	@r_nocontextpics	#outofcontext
r_oddlysatisfying 	@oddly_satisfy	#gifs
r_opensignups 	@r_opensignups	#torrent
r_osugame 	@r_osugame	
r_overwatch 	@r_overwatch	#gaming
r_pantsu 	@r_pantsu	#anime #porn
r_pcmasterrace 	@r_pcmasterrace	#gaming
r_pewdiepiesubmissions 	@r_PewdiepieSubmissions	#memes
r_photoshopbattles 	@r_photoshopbattles	#pic
r_pics 	@r_pics_redux	#pic
r_podcasts 	@r_Podcasts	#podcast
r_porn 	@r_porn	#porn #sfw
r_pornhubcomments 	@r_pornhubcomments	#porn
r_privacy 	@r_privacy	#privacy
r_programming 	@r_Pr0gramming	#programming
r_punny 	@R_Punny	
r_quotesporn 	@r_quotesporn	#porn
r_ramen 	@r_ramen	#ramen
r_reddevils 	@r_reddevils	
r_remotejs 	@r_remotejs	
r_rimworld 	@r_RimWorld	#gaming
r_rupaulsdragrace 	@r_rupaulsdragrace	
r_sbubby 	@r_sbubby	#logos #fun
r_selfhosted 	@r_SelfHosted	
r_shittyramen 	@r_shittyramen	#ramen #pic
r_showerthoughts 	@r_Showerthoughts	#deep #text
r_slimerancher 	@r_SlimeRancher	#gaming
r_softwaregore 	@r_softwaregore	#baddesign
r_space 	@r_space	#science #space
r_streetwear 	@r_streetwear	#fashion
r_suggest 	@r_suggest	#book
r_switchhacks 	@r_SwitchHacks	#gaming
r_talesfromtechsupport 	@r_talesfromtechsupport	#tech
r_technope 	@r_technope	#tech
r_techsupportgore 	@r_TechSupportGore	#tech
r_texans 	@r_texans	#texans
r_therewasanattempt 	@r_therewasanattempt	#memes #gif #fun
r_thinkpadsforsale 	@r_thinkpadsforsale	#sale #pc
r_tihi 	@r_TIHI	#thanksihateit #tihi #wtf #ihateit
r_til 	@r_til	#learning
r_tinder 	@rtinder	#tinder
r_trackers 	@r_trackers	#torrent
r_unexpected 	@r_unexpected	#fun
r_vault_hunters 	@r_vault_hunters	#gaming 
r_vim 	@r_vim	#programming
r_vinyl 	@r_vinyl	#music
r_wellthatsucks 	@r_wellthatsucks	
r_wheredidthesodago 	@r_wheredidthesodago	#outofcontext
r_wholesomememes 	@r_wholesomememes	#memes
r_wikileaks 	@r_WikiLeaks	#wikileaks
r_woooosh 	@r_woooosh	
r_wow 	@r_wow	#gaming
r_wpdi 	@r_WatchPeopleDieInside	#memes #gif #fun
r_xboxone 	@r_xboxone	#gaming
r_xxxtentacion 	@r_xxxtentacion	
r_youtubehaiku 	@r_youtubehaiku	#video
rareinsults 	@rareinsults	
rcarporn 	@rcarporn	#sfw #porn
rcosplaygirls 	@rcosplaygirls	#girls
rddit 	@rddit	#reddit #gif
reddit_all 	@reddit_all	#global #all
reddit_androiddev 	@reddit_androiddev	#android #programming
reddit_cartoons 	@reddit_cartoons	#cartoons
reddit_xiaomi 	@reddit_xiaomi	#android
reddit2telegram	@reddit2telegram	#reddit #telegram #meta
redditart 	@redditart	#art
redditpiracy 	@redditpiracy	#piracy
redditvideos 	@redditvideos	#video
rhqdesi 	@rhqdesi	
rsoccerbetting 	@rsoccerbetting	#soccer #sport #betting
rtf2memes 	@rtf2memes	#memes
shitliberalssay 	@ShitLiberalsSay	
soccer_reddit 	@soccer_reddit	#sport
streetmoe 	@streetmoe	
sub_eminem 	@sub_eminem	#music #hiphop #rap
therightcantmeme 	@therightcantmeme	#memes
wasletztepreis 	@r_wasletztepreis	#german
whitepeopletweets 	@whitepeopletweets	#twitter
ya_metro 	@ya_metro	#publictransport #metro #tram #subway #underground
youtubecompendium 	@YoutubeCompendium	#news